NO ./textures/north.xpm
SO ./textures/south.xpm
EA ./textures/east.xpm
WE ./textures/west.xpm

F 220,100,0   
C 255,30,0

1111111111111111111111111111
1000000000111011
1001000000111111
10000000001
10000000001
10000000001
10000000001
10000000001
10000000001
10000001111
10000010001
10000010001
10000011001
1000000100011111111111111111111111111111111111111111111111111111111111111111111111111111111
10000000N0000000000000000000000000000000000000000000000000000000000000000000000000000000001
1000000000000000000000000000000000000000000000000000000000000000000000000000000000000000001
1000000000000000000000000000000000000000000000000000000000000000000000000000000000000000001
1000000000000000000000000000000000000000000000000000000000000000000000000000000000000000001
1000000000000000000000000000000000000000000000000000000000000000000000000000000000000000001
1000000000000000000000000000000000000000000000000000000000000000000000000000000000000000001
1000000000000000000000000000000000000000000000000000000000000000000000000000000000000000001
1000000000000000000000000000000000000000000000000000000000000000000000000000000000000000001
1000000000111111111111111111111111111111111111111111111111111111111111111111111111111111111
11111111111
